xx<<<<<<<<<<<xx<xxs<<<xx
xx<<<<<<<<<<<xx<xxs<<<xx
vv#e#########vv#SS###e^^
vv###########vv#^^####^^
vv##########evv#^^e###^^
vv#e#########vv#^^####^^
xx<<<<xxs<<<<xx#^^####^^
xx<<<<xxs<<<<xx#^^####^^
vv####SS#####vv#^^####^^
vve##e^^####evv#^^####^^
vv####^^#####vv#^^e###^^
SS####^^#####vv#^^####^^
xxs<<<xx<<<<xxx<xxx<<<xx
xxs<<<xx<<<<xxx<xxx<<<xx
vv##########vv###^^###^^
xx>>>>xx>>>>xxx>xxx>>sxx
xx>>>>xx>>>>xxx>xxx>>sxx
vv####vv##e##vv#^^####SS
vv####vv#####vv#^^####^^
vv####vv#####vv#^^###e^^
vv###evv####evv#^^####^^
vv####vv#####vv#^^####^^
vv####SS#####SS#^^#e##^^
xx>>>sxx>>>>sxx>xx>>>>xx
xx>>>sxx>>>>sxx>xx>>>>xx