xx<<<<<<<<<<<xx<xxs<<<xx
xx<<<<<<<<<<<xx<xxs<<<xx
vv#e#########vv#ss###e^^
vv###########vv#vv####^^
vv##########evv#vve###^^
vv#e#########vv#vv####^^
xx<<<<<<s<<<<xx#vv####^^
xx<<<<<<s<<<<xx#vv####^^
vv####ss#####vv#vv####^^
vve##e^^####evv#vv####^^
vv####^^#####vv#vve###^^
ss####^^#####vv#vv####^^
xxs<<<xx<<<<xxx<xxx<<<xx
xxs<<<xx<<<<xxx<xxx<<<xx
vv##########vv###^^###^^
xx>>>>xx>>>>xxx>xxx>>sxx
xx>>>>xx>>>>xxx>xxx>>sxx
vv####vv##e##vv#^^####ss
vv####vv#####vv#^^####^^
vv####vv#####vv#^^###e^^
vv###evv####evv#^^####^^
vv####vv#####vv#^^####^^
vv####ss#####ss#^^#e##^^
xx>>>sxx>>>>sxx>xx>>>>xx
xx>>>sxx>>>>sxx>xx>>>>xx